S    #   # # ## l
#### ### # #    l
   # #   # ## # l
   # # # # ## # l
   # # # #    # l
   # # # ###### l
   # # #        l
   # ###        l
   #            l
     # # # #    l
       # #      l
     ### ####   l
                l
     ### #### ##l
       # #    ##l
     # # #  #  Fl
----------------J
